1.5,1.5:20,60
S2.5,4.5:D10.5,18.5:K16.5,9.5:A16.5,25.5:A17.5,50.5:S18.5,43.5:D19.5,51.5:D20.5,58.5
11111111111111111111111111111111111111111111111111111111111111
10000100100011111111111111111111111111111111111111111111111111
11110110001000011111111111111110111111111111111111111111111111
11110000111111000011111111000100111111111111111111111111111111
11111111111111000001111100000100111111111111111111111111111111
11111111111111110101110101000000110000111111111111111111111111
11111111111111100001110000000000000000111100001110111111111111
11111111111111110000100111100000010000000001100000111111111111
11111111111111111100010011000001001100000111100000000011111111
11111111011111111000000010000111000000011111000001110011111111
11110100011111111001100001011111100000010011000000000010001111
11100001001111111111100001011101110000110001000001101000001111
10000110001111111111100000000101000000010100000001100000001101
11111111001111111111100000100100000010010000000001100000000001
11111111011111111110000100000000011010000100000000000000000011
11111110001110000000000000000111111000000100000000000000000001
11111111100000001100000100000001011011000000110000000000000001
11111111111100111100001110001000000110000000000000000000000001
11111111111111111100011100001000000000000100000000001100100001
11111111111111111100000000000000000000001111100001100000000001
11111111111111111111111111100000000000011111111111111100000001
11111111111111111111111111111111111111111111111111111111111141