1.5,1.5:18,28
A2.5,9.5:D3.5,5.5:A3.5,11.5:H4.5,15.5:A5.5,2.5:K5.5,8.5:H5.5,23.5:A6.5,11.5:A7.5,2.5:H8.5,5.5:H8.5,13.5:H9.5,9.5:H15.5,6.5:H15.5,25.5:H17.5,17.5
111111111111111111111111111111
100000000000000003000000000001
100000000000000003000000000001
100000000000000003000000000001
100000000000000002000000000001
100000000000000003000000000001
100000000000000003000000000001
100000000000000003000000000001
100000000000000033000000000001
100000000000000030000000000001
133333000000000300000000000001
100003332333333300000000000001
100000000000000000000000000001
100000000000000000000000000001
100000000000000000000000000001
100000000000000000000000000001
100000000000000000000000000001
100000000000000000000000000001
100000000000000000000000000001
111111111111111111111111111111
