1.5,1.5:20,60
A2.5,47.5:A3.5,29.5:S5.5,24.5:S6.5,13.5:S8.5,36.5:K9.5,39.5:S10.5,34.5:A11.5,13.5:K19.5,39.5
11111111111111111111111111111111111111111111111111111111111111
10011000011111111110000111111100011110000100000000111111111111
11011101000111100000010010001101111100000001100000111111111111
11000000000011001110011000000000001100000101111000011111111111
11111111100000011111100001001010000000000001000000000001111111
11111111110000001001100001001000000000001001011111000000111111
11111111110000000000000000110000000000000000011111000000001111
11111111111000000000000000000000000000000000010011111100000111
11111101111101100000000000000000000000000110000011110100010101
11111100011100100000000000001000000100000111110000000100000001
11000001011100000001000100000000000000000011110000000110000001
10000010000000000001111100000011010000111011110000000110110001
10001111110000111111111111110000000000111000000000000111111001
10001111111100111111111111111001100011111110111000000110111001
10001111111111111111111111111000100000011111111001101000100011
11111111111111111111111111111100000100001111110000000000000111
11111111111111111111111111111101000000001110000010000001000111
11111111111111111111111111111001111100000010000110000000000111
11111111111111111111111111111001111100001000000010000000000001
11111111111111111111111111111101111111000000000000010000000001
11111111111111111111111111111101111111110000000010010000000001
11111111111111111111111111111111111111111111111111111111111141