1.5,1.5:13,26
S2.5,17.5:D2.5,24.5:A4.5,13.5:S9.5,26.5:A10.5,4.5:S10.5,15.5:S11.5,6.5:A11.5,11.5
111111111111111111111111111111111111
100000000001000000000001000000000001
100000000001000000000001000000000001
100000000001000000000001000000000001
100000000000000000000001111111100111
100000000000000000000000000000000001
100000000001000000000000000000000001
100000000001111111111111001111111111
111100111111000000000000000010000001
100000000100000000000000000010000001
100000000000000000010000000010000001
100000000000000000010000000000000001
100000000100000000010000000000000001
111111111111111111111111110111111111
111111111111111111111111114111111111
