4.5,4.5:13,26
111111111111111111111111111111111111
100000000001000000000001000000000001
100000000001000000000001000000000001
100000000001000000000001000000000001
100000000000000000000001111111100111
100000000000000000000000000000000001
100000000001000000000000000000000001
100000000001111111331111001111111111
111100111111000000000000000010000001
100000000100000000000000000010000003
100000000000000000010000000010000001
100000000000000000010000000000000001
100000000100000000010000000000000001
111111111111111111111111110111111111
111111111111111111111111114111111111
