2.5,27.5:18,1
A2.5,23.5:S3.5,11.5:S4.5,5.5:A4.5,23.5:A5.5,24.5:A5.5,26.5:A5.5,28.5:S6.5,5.5:A6.5,9.5:A6.5,13.5:S6.5,16.5:D8.5,4.5:A8.5,9.5:A8.5,17.5:A10.5,7.5:S11.5,5.5:A13.5,13.5:S13.5,20.5:A14.5,8.5:S15.5,12.5:S16.5,28.5:S17.5,8.5:A18.5,22.5:D18.5,24.5
333333333333333333333333333333
333333333300000000033333000003
300030000300003333000000000003
303333300300003333333333000003
300030000300003000000000000003
303333300333303000033333030303
300030000000303000030000030303
303333300330303000030033330303
300000000000003330330030000303
333333333333300000330030033303
300000000000333333330030030003
300000003330003000300030030003
303330030000003000300030030033
300030300033303030300030030003
300030000030003000000030030003
333033330030003333333330033003
300000030030000003000000030003
300030030030333333003333330033
300030000030000000000000030003
343333333333333333333333333333
