1.5,17:27,35
1111111111111111111111111111111111111111
1000000000000001000100000000000000000001
1000000000000001000100000000000000000001
1000000000000001000100000000000000000001
1000000000000001000100000000000000000001
1000000000000000000000000000000000000001
1000000000000000000000000000000000000001
1000111111111111000111110000111110001111
1000100000000001000100000000001000000001
1000000000000001000100000000001000000001
1000000000000001000100000000001000000001
1000100111000001000100000000001000000001
1000100001000001000100000000001000000001
1000100001000001000100000000001000000001
1000100001000001000100000000001000000001
1000111111000001000100000000001000000001
1000000000000001000111111111001001111111
1111111111111001000100000001001001000001
1000000100000001000100000001001001000001
1000000100000001000100000001001001000001
1000000000000001000100001001001001001001
1000000000000001000100001001001001001001
1000000100000001000100001000001000001001
1111111100000001000100001000001000001001
1000000100000001000100001111111111111001
1000000000000001000100000000000000000001
1000000000000001000100111111111111111001
1000000100000001000100000000000001400001
1111111111111111111111111111111111111111
