1.5,1.5:7,7
A3.5,5.5:D4.5,3.5:H5.5,6.5:H6.5,4.5
111111111111111111111111111111
100000003000000000000000000001
100000003000000000000000000001
100000003000000000000000000001
100000003000000000000000000001
100000003000000000000000000001
100000003000000000000000000001
100000003000000000000000000001
133333343000000000000000000001
100000000000000000000000000001
100000000000000000000000000001
100000000000000000000000000001
100000000000000000000000000001
100000000000000000000000000001
100000000000000000000000000001
100000000000000000000000000001
100000000000000000000000000001
100000000000000000000000000001
100000000000000000000000000001
111111111111111111111111111111
