1.5,1.5:3,3
S1.5,3.5:A3.5,1.5
111111111111111111111111111111
100010000000000000000000000001
100010000000000000000000000001
100010000000000000000000000001
111110000000000000000000000001
100000000000000000000000000001
100000000000000000000000000001
100000000000000000000000000001
100000000000000000000000000001
100000000000000000000000000001
100000000000000000000000000001
100000000000000000000000000001
100000000000000000000000000001
100000000000000000000000000001
100000000000000000000000000001
100000000000000000000000000001
100000000000000000000000000001
100000000000000000000000000001
100000000000000000000000000001
111111111111111111111111111111
