1,1
111111111111111111111111111111
100000000000000000000000000001
100000000000000000000000000001
100000000000000000000000000001
300000000000000000000000000001
300000000000000000000000000001
300000000003333000000000000001
300000000000000300000000000001
100000000030003000000000000001
100000000030030000000000000001
100000000003300000000000000001
100000000000000000000000000001
100000000000000000000000000001
100000000010000000000000000001
100000000000000000000000000001
100000000000000000000000000001
100000000000000000000000000001
100000000000000000000000000001
100000000000000000000000000001
111111111111111111111111111111
